+--+--+--+--+--+
|           *  |
+  +--+--+  +  +
|  |  g  |     *
+  +--+  +--+  +
|     |     |  *
+--+  +--+  +  +
|     |  |     *
+  +**+--+   **+
|        |     *
+--+--+--+--+**+
